[TILES] {
    -10,-3: 0
    -10,-4: 21
    -10,-5: 42
    -2,-3: 2
    -2,-4: 23
    -2,-5: 44
    -3,-2: 3
    -3,-3: 22
    -3,-4: 22
    -3,-5: 43
    -4,-3: 1
    -4,-4: 22
    -4,-5: 43
    -5,-3: 1
    -5,-4: 22
    -5,-5: 43
    -6,-3: 1
    -6,-4: 22
    -6,-5: 43
    -7,-3: 1
    -7,-4: 22
    -7,-5: 43
    -8,-3: 1
    -8,-4: 22
    -8,-5: 43
    -9,-2: 3
    -9,-3: 22
    -9,-4: 22
    -9,-5: 43
}
[UNITS] {
}
