[TILES] {
    -10,-3: 5
    -10,-4: 5
    -10,-5: 5
    -2,-3: 5
    -2,-4: 5
    -2,-5: 5
    -3,-2: 5
    -3,-3: 5
    -3,-4: 5
    -3,-5: 5
    -4,-3: 5
    -4,-4: 5
    -4,-5: 5
    -5,-3: 5
    -5,-4: 5
    -5,-5: 5
    -6,-3: 5
    -6,-4: 5
    -6,-5: 5
    -7,-3: 5
    -7,-4: 5
    -7,-5: 5
    -8,-3: 5
    -8,-4: 5
    -8,-5: 5
    -9,-2: 5
    -9,-3: 5
    -9,-4: 5
    -9,-5: 5
}
[UNITS] {
}
